Level 1
 8 0 0 0 1 0 1 0 1 0 1  
 8 0 0 0 0 0 0 0 0 0 0  
 8 0 0 0 0 2 0 2 0 2 0  
 8 0 0 0 0 0 0 0 0 0 0  
 8 0 0 0 3 0 3 0 3 0 3  
Level 2
 0 0 2 2 2 2 2 2 2 2 2 2  
 0 0 3 6 7 4 3 6 7 4 3 6  
 0 0 6 7 6 7 6 7 6 7 6 7  
 0 0 7 3 1 6 7 4 1 6 7 4  
 0 0 6 7 6 7 6 7 6 7 6 7  
 0 0 3 6 7 4 3 6 7 4 3 6  
 0 0 2 2 2 2 2 2 2 2 2 2   
Level 3
 0 5 5 5 5 5 5 5 5 5 5 5 5 
 0 5 0 0 0 0 0 0 0 0 0 0 5 
 0 5 0 0 0 0 0 0 0 0 0 0 5 
 0 5 0 0 6 3 6 3 6 3 0 0 5 
 0 5 0 0 1 6 3 6 1 6 0 0 5 
 0 5 0 0 6 3 6 3 6 3 0 0 5 
 0 5 0 0 0 0 0 0 0 0 0 0 5 
 0 5 0 0 0 0 0 0 0 0 0 0 5 
 0 5 5 5 5 5 5 5 5 5 5 5 5  
Level 4
 0 6 6 6 6 6 6 6 6 6 6 6 6 
 0 6 3 3 3 3 3 3 3 3 3 3 6 
 0 6 1 2 3 4 1 2 3 4 1 2 6 
 0 6 4 1 2 1 2 1 2 1 2 1 6 
 0 6 3 4 1 2 3 4 1 2 3 4 6 
 0 6 4 1 2 1 2 1 2 1 2 1 6 
 0 6 1 2 3 4 1 2 3 4 1 2 6 
 0 6 3 3 3 3 3 3 3 3 3 3 6 
 0 6 6 6 6 6 6 6 6 6 6 6 6 
Level 5
 7 7 7 7 7 7 7 7 7 7 7 7 7 7
 7 3 3 3 3 3 3 3 3 3 3 3 3 7
 7 3 2 4 5 4 2 4 5 4 2 4 3 7
 7 3 4 2 4 2 4 2 4 2 4 2 3 7
 7 3 6 4 2 4 6 4 2 4 6 4 3 7
 7 3 4 2 4 2 4 2 4 2 4 2 3 7
 7 3 2 4 5 4 2 4 5 4 2 4 3 7
 7 3 3 3 3 3 3 3 3 3 3 3 3 7
 7 7 7 7 7 7 7 7 7 7 7 7 7 7
End
